ISAD(G) to EAD3 
Source: https://loc.gov/ead/EAD3taglib/EAD3.html#appendix-AppendixAEADCrosswalks

ISAD(G) EAD
3.1.1 Reference code(s)	<agencycode> and <recordid> within <control>; <unitid> with @countrycode and @repositorycode
3.1.2 Title	<unittitle>
3.1.3 Dates	<unitdate>, <unitdatestructured>
3.1.4 Level of description	<archdesc> and <c>@level
3.1.5 Extent and medium of the unit	<physdesc>, <physdescstructured>
3.2.1 Name of creator	<origination>
3.2.2 Administrative/Biographical history	<bioghist>
3.2.3 Archival history	<custodhist>
3.2.4 Immediate source of acquisition	<acqinfo>
3.3.1 Scope and content	<scopecontent>
3.3.2 Appraisal, destruction and scheduling	<appraisal>
3.3.3 Accruals	<accruals>
3.3.4 System of arrangement	<arrangement>
3.4.1 Conditions governing access	<accessrestrict>
3.4.2 Conditions governing reproduction	<userestrict>
3.4.3 Language/scripts of material	<langmaterial>
3.4.4 Physical characteristics and technical requirements	<phystech>
3.4.5 Finding aids	<otherfindaid>
3.5.1 Existence and location of originals	<originalsloc>
3.5.2 Existence and location of copies	<altformavail>
3.5.3 Related units of description	<relatedmaterial>, <separatedmaterial>
3.5.4 Publication note	<bibliography>
3.6.1 Note	<didnote>, <odd>
3.7.1 Archivist's note	<processinfo>
3.7.2 Rules or conventions	<conventiondeclaration>
3.7.3 Date(s) of descriptions	<maintenanceevent>/<eventdatetime>
